さんだんじゅう	散弾銃	固有名詞	TF2のスカウトのメイン武器
ふぉーすあねーちゃー	フォース・ア・ネイチャー	固有名詞	TF2のスカウトのメイン武器
しょーとすとっぷ	ショートストップ	固有名詞	TF2のスカウトのメイン武器
そーだぽっぱー	ソーダ・ポッパー	固有名詞	TF2のスカウトのメイン武器
べびーふぇいすずぶらすたー	ベビーフェイスズ・ブラスター	固有名詞	TF2のスカウトのメイン武器

ぴすとる	ピストル	固有名詞	TF2のスカウトのサブ武器
るがーもーふ	ルガーモーフ	固有名詞	TF2のスカウトのサブ武器
うぃんがー	ウィンガー	固有名詞	TF2のスカウトのサブ武器
ぷりてぃぼーいずぽけっとぴすとる	プリティボーイズ・ポケットピストル	固有名詞	TF2のスカウトのサブ武器
ふらいんぐぎろちん	フライング・ギロチン	固有名詞	TF2のスカウトのサブ武器
ぼんくあとみっくぱんち	Bonk! アトミックパンチ	固有名詞	TF2のスカウトのサブ武器
くりてぃこーら	クリティコーラ	固有名詞	TF2のスカウトのサブ武器
まっどみるく	マッドミルク	固有名詞	TF2のスカウトのサブ武器

ばっと	バット	固有名詞	TF2のスカウトの近接
ほーりーまらかる	ホーリーマラカル	固有名詞	TF2のスカウトの近接
あんあーむどこんばっと	アンアームド・コンバット	固有名詞	TF2のスカウトの近接
さんどまん	サンドマン	固有名詞	TF2のスカウトの近接
きゃんでぃーけーん	キャンディー・ケーン	固有名詞	TF2のスカウトの近接
ぼすとんばっしゃー	ボストン・バッシャー	固有名詞	TF2のスカウトの近接
すりーるーんぶれいど	スリールーン・ブレイド	固有名詞	TF2のスカウトの近接
さんおんあすてぃっく	サン・オン・ア・スティック	固有名詞	TF2のスカウトの近接
ふぁんおぶうぉー	ファンオブウォー	固有名詞	TF2のスカウトの近接
あとまいざー	アトマイザー	固有名詞	TF2のスカウトの近接
らっぷあさしん	ラップ・アサシン	固有名詞	TF2のスカウトの近接



ろけっとらんちゃー	ロケットランチャー	固有名詞	TF2のソルジャーのメイン武器
おりじなる	オリジナル	固有名詞	TF2のソルジャーのメイン武器
だいれくとひっと	ダイレクトヒット	固有名詞	TF2のソルジャーのメイン武器
ぶらっくぼっくす	ブラックボックス	固有名詞	TF2のソルジャーのメイン武器
ろけっとじゃんぱー	ロケットジャンパー	固有名詞	TF2のソルジャーのメイン武器
りばてぃーらんちゃー	リバティー・ランチャー	固有名詞	TF2のソルジャーのメイン武器
かうまんぐらー5000	カウ・マングラー 5000	固有名詞	TF2のソルジャーのメイン武器
べがーずばすーか	ベガーズ・バズーカ	固有名詞	TF2のソルジャーのメイン武器

しょっとがん	ショットガン	固有名詞	TF2のソルジャーのサブ武器
りざーぶしゅーたー	リザーブ・シューター	固有名詞	TF2のソルジャーのサブ武器
ばふばなー	バフ・バナー	固有名詞	TF2のソルジャーのサブ武器
がんぼーと	ガンボート	固有名詞	TF2のソルジャーのサブ武器
ばたりおんずばっくあっぷ	バタリオンズ・バックアップ	固有名詞	TF2のソルジャーのサブ武器
こんからー	コンカラー	固有名詞	TF2のソルジャーのサブ武器
まんとれっず	マントレッズ	固有名詞	TF2のソルジャーのサブ武器
らいちゃすばいそん	ライチャス・バイソン	固有名詞	TF2のソルジャーのサブ武器

しゃべる	シャベル	固有名詞	TF2のソルジャーの近接
いこらいざー	イコライザー	固有名詞	TF2のソルジャーの近接
ぺいんとれいん	ペイン・トレイン	固有名詞	TF2のソルジャーの近接
はーふざとういち	ハーフ座頭市	固有名詞	TF2のソルジャーの近接
でぃしぷりなりーあくしょん	ディシプリナリー・アクション	固有名詞	TF2のソルジャーの近接
まーけっとがーでなー	マーケット・ガーデナー	固有名詞	TF2のソルジャーの近接
えすけーぷぷらん	エスケープ・プラン	固有名詞	TF2のソルジャーの近接



かえんほうしゃき	火炎放射器	固有名詞	TF2のパイロのメイン武器
れいんぶろわー	レインブロワー	固有名詞	TF2のパイロのメイン武器
ばっくばーなー	バックバーナー	固有名詞	TF2のパイロのメイン武器
でぃぐりーさー	ディグリーザー	固有名詞	TF2のパイロのメイン武器
ふろぎすてぃねーたー	フロギスティネーター	固有名詞	TF2のパイロのメイン武器

しょっとがん	ショットガン	固有名詞	TF2のパイロのサブ武器
りざーぶしゅーたー	リザーブ・シューター	固有名詞	TF2のパイロのサブ武器
ふれあーがん	フレアーガン	固有名詞	TF2のパイロのサブ武器
でとねーたー	デトネーター	固有名詞	TF2のパイロのサブ武器
まんめるたー	マンメルター	固有名詞	TF2のパイロのサブ武器
すこーちしょっと	スコーチ・ショット	固有名詞	TF2のパイロのサブ武器

しょうぼうおの	消防斧	固有名詞	TF2のパイロの近接
ろりちょっぷ	ロリチョップ	固有名詞	TF2のパイロの近接
あくすてぃんぐいしゃー	アクスティングイシャー	固有名詞	TF2のパイロの近接
ぽすたるぱめらー	ポスタル・パメラー	固有名詞	TF2のパイロの近接
ほーむれっかー	ホームレッカー	固有名詞	TF2のパイロの近接
まうる	マウル	固有名詞	TF2のパイロの近接
ぱわーじゃっく	パワージャック	固有名詞	TF2のパイロの近接
ばっくすくらっちゃー	バック・スクラッチャー	固有名詞	TF2のパイロの近接
しゃーぺんどぼるけいのふらっぐめんと	シャーペンド・ボルケイノ・フラッグメント	固有名詞	TF2のパイロの近接
さーどでぃぐりー	サード・ディグリー	固有名詞	TF2のパイロの近接
ねおんあないあれいたー	ネオン・アナイアレイター	固有名詞	TF2のパイロの近接



ぐれねーどらんちゃー	グレネードランチャー	固有名詞	TF2のデモマンのメイン武器
ろっくんろーど	ロックン・ロード	固有名詞	TF2のデモマンのメイン武器
ありばばずうぃーぶーつ	アリババズ・ウィーブーツ	固有名詞	TF2のデモマンのメイン武器
ぶーとれっがー	ブートレッガー	固有名詞	TF2のデモマンのメイン武器
るーずきゃのん	ルーズ・キャノン	固有名詞	TF2のデモマンのメイン武器

ねんちゃくばくだんらんちゃー	粘着爆弾ランチャー	固有名詞	TF2のデモマンのサブ武器
すこてぃっしゅれじすたんす	スコティッシュ・レジスタンス	固有名詞	TF2のデモマンのサブ武器
ちゃーじんたーじ	チャージン・タージ	固有名詞	TF2のデモマンのサブ武器
すてぃっきーじゃんぱー	スティッキージャンパー	固有名詞	TF2のデモマンのサブ武器
すぷれんでぃっどすくりーん	スプレンディッド・スクリーン	固有名詞	TF2のデモマンのサブ武器

ぼとる	ボトル	固有名詞	TF2のデモマンの近接
すこてぃっしゅはんどしぇいく	スコティッシュ・ハンドシェイク	固有名詞	TF2のデモマンの近接
あいらんだー	アイランダー	固有名詞	TF2のデモマンの近接
ほーすれすへっどれすほーすまんずへっどていかー	ホースレス・ヘッドレス・ホースマンズ・ヘッドテイカー	固有名詞	TF2のデモマンの近接
ねっしーずないんあいあん	ネッシーズ・ナインアイアン	固有名詞	TF2のデモマンの近接
すこっつまんずすかるかったー	スコッツマンズ・スカルカッター	固有名詞	TF2のデモマンの近接
ぺいんとれいん	ペイントレイン	固有名詞	TF2のデモマンの近接
うらぷーるけいばー	ウラプール・ケイバー	固有名詞	TF2のデモマンの近接
くれふもあ	クレフモア	固有名詞	TF2のデモマンの近接
はーふざとういち	ハーフ座頭市	固有名詞	TF2のデモマンの近接
ぺるしあんぱーすえいだー	ペルシアン・パースエイダー	固有名詞	TF2のデモマンの近接



みにがん	ミニガン	固有名詞	TF2のヘビーのメイン武器
あいあんかーてん	アイアン・カーテン	固有名詞	TF2のヘビーのメイン武器
なたーしゃ	ナターシャ	固有名詞	TF2のヘビーのメイン武器
ぶらすびーすと	ブラス・ビースト	固有名詞	TF2のヘビーのメイン武器
とみすらヴ	トミスラヴ	固有名詞	TF2のヘビーのメイン武器
ふぉーろんひーたー	フォー・ロン・ヒーター	固有名詞	TF2のヘビーのメイン武器

しょっとがん	ショットガン	固有名詞	TF2のヘビーのサブ武器
ふぁみりーびじねす	ファミリー・ビジネス	固有名詞	TF2のヘビーのサブ武器
さんどヴぃっち	サンドヴィッチ	固有名詞	TF2のヘビーのサブ武器
ろぼ・さんどヴぃっち	ロボ・サンドヴィッチ	固有名詞	TF2のヘビーのサブ武器
だーろっくすばー	Dalokohs バー	固有名詞	TF2のヘビーのサブ武器
ふぃっしゅけーき	フィッシュケーキ	固有名詞	TF2のヘビーのサブ武器
ばっふぁろーすてーきさんどヴぃっち	バッファロー・ステーキ・サンドヴィッチ	固有名詞	TF2のヘビーのサブ武器

こぶし	拳	固有名詞	TF2のヘビーの近接
あぽこふぃすつ	アポコ・フィスツ	固有名詞	TF2のヘビーの近接
きりんぐぐろーぶおぶぼくしんぐ	キリング・グローブ・オブ・ボクシング	固有名詞	TF2のヘビーの近接
ぐろーぶおぶらんにんぐあーじぇんとりー	グローブ・オブ・ランニング・アージェントリー	固有名詞	TF2のヘビーの近接
うぉーりあーずすぴりっと	ウォーリアーズ・スピリット	固有名詞	TF2のヘビーの近接
ふぃすつおぶすちーる	フィスツ・オブ・スチール	固有名詞	TF2のヘビーの近接
えぴくしょんのーてぃす	エピクション・ノーティス	固有名詞	TF2のヘビーの近接
ほりでーぱんち	ホリデー・パンチ	固有名詞	TF2のヘビーの近接



しょっとがん	ショットガン	固有名詞	TF2のエンジニアのメイン武器
ふろんてぃあじゃすてぃす	フロンティア・ジャスティス	固有名詞	TF2のエンジニアのメイン武器
うぃどうめーかー	ウィドウメーカー	固有名詞	TF2のエンジニアのメイン武器
ぽむぞん６０００	ポムゾン6000	固有名詞	TF2のエンジニアのメイン武器
れすきゅーれんじゃー	レスキュー・レンジャー	固有名詞	TF2のエンジニアのメイン武器

ぴすとる	ピストル	固有名詞	TF2のエンジニアのサブ武器
るがーもーふ	ルガーモーフ	固有名詞	TF2のエンジニアのサブ武器
らんぐらー	ラングラー	固有名詞	TF2のエンジニアのサブ武器
しょーとさーきっと	ショート・サーキット	固有名詞	TF2のエンジニアのサブ武器

すぱな	スパナ	固有名詞	TF2エンジニアの近接
ごーるでんれんち	ゴールデンレンチ	固有名詞	TF2エンジニアの近接
がんすりんがー	ガンスリンガー	固有名詞	TF2エンジニアの近接
さうざんほすぴたりてぃ	サウザン・ホスピタリティ	固有名詞	TF2エンジニアの近接
じゃぐ	ジャグ	固有名詞	TF2エンジニアの近接
ゆーりかえふぇくと	ユーリカ・エフェクト	固有名詞	TF2エンジニアの近接



ちゅうしゃじゅう	注射銃	固有名詞	TF2のメディックのメイン武器
ぶるーとざおがー	ブルートザオガー	TF2のメディックのメイン武器
くるせいだーずくろすぼう	クルセイダーズ・クロスボウ	TF2のメディックのメイン武器
おーばーどーず	オーバードーズ	TF2のメディックのメイン武器

めでぃがん	メディガン	固有名詞	TF2のメディックのサブ武器
くりっつくりーく	クリッツクリーク	固有名詞	TF2のメディックのサブ武器
くいっくふぃっくす	クイックフィックス	固有名詞	TF2のメディックのサブ武器
ヴぁくさねーたー	ヴァクサネーター	固有名詞	TF2のメディックのサブ武器

ほねようでんのこ	骨用電ノコ	固有名詞	TF2のメディックの近接
ゆーばーそう	ユーバーソウ	固有名詞	TF2のメディックの近接
ヴぃたそう	ヴィタ・ソウ	固有名詞	TF2のメディックの近接
あんぴゅてーたー	アンピュテーター	固有名詞	TF2のメディックの近接
されむばう	サレム・バウ	固有名詞	TF2のメディックの近接



すないぱーらいふる	スナイパーライフル	固有名詞	TF2のスナイパーのメイン武器
あうぱーはんど	AWPerハンド	固有名詞	TF2のスナイパーのメイン武器
はんつまん	ハンツマン	固有名詞	TF2のスナイパーのメイン武器
ふぉーてぃふぁいどこんぱうんど	フォーティファイド・コンパウンド	固有名詞	TF2のスナイパーのメイン武器
しどにーすりーぱー	シドニースリーパー	固有名詞	TF2のスナイパーのメイン武器
ばざーるばーげん	バザール・バーゲン	固有名詞	TF2のスナイパーのメイン武器
まきな	マキナ	固有名詞	TF2のスナイパーのメイン武器
ひっとまんずひーとめーかー	ヒットマンズ・ヒートメーカー	固有名詞	TF2のスナイパーのメイン武器

さぶましんがん	SMG	固有名詞	TF2のスナイパーのサブ武器
くりーなーずかーびん	クリーナーズ・カービン	固有名詞	TF2のスナイパーのサブ武器
じゃらて	ジャラテ	固有名詞	TF2のスナイパーのサブ武器
れいざーばっく	レイザーバック	固有名詞	TF2のスナイパーのサブ武器
だーうぃんずでんじゃーしーるど	ダーウィンズデンジャーシールド	固有名詞	TF2のスナイパーのサブ武器
こーじーきゃんぱー	コージー・キャンパー	固有名詞	TF2のスナイパーのサブ武器

くくりとう	ククリ刀	固有名詞	TF2のスナイパーの近接
とらいばるまんずしぶ	トライバルマンズ・シブ	固有名詞	TF2のスナイパーの近接
ぶっしゅわっか	ブッシュワッカ	固有名詞	TF2のスナイパーの近接
しゃーはんしゃー	シャーハンシャー	固有名詞	TF2のスナイパーの近接



りぼるばー	リボルバー	固有名詞	TF2のスパイのメイン武器
びっぐきる	ビッグキル	固有名詞	TF2のスパイのメイン武器
あんばさだー	アンバサダー	固有名詞	TF2のスパイのメイン武器
えとらんぜ	エトランゼ	固有名詞	TF2のスパイのメイン武器
えんふぉーさー	エンフォーサー	固有名詞	TF2のスパイのメイン武器
だいあもんどばっく	ダイアモンドバック	固有名詞	TF2のスパイのメイン武器

さっぱー	サッパー	固有名詞	TF2のスパイのサブ武器
あぷさっぷ	Ap-Sap	固有名詞	TF2のスパイのサブ武器
れっどてーぷれこーだー	レッドテープ・レコーダー	固有名詞	TF2のスパイのサブ武器

ないふ	ナイフ	固有名詞	TF2のスパイの近接
しゃーぷどれっさー	シャープ・ドレッサー	固有名詞	TF2のスパイの近接
ぶらっくろーず	ブラック・ローズ	固有名詞	TF2のスパイの近接
ゆあえたーなるりわーど	ユア・エターナル・リワード	固有名詞	TF2のスパイの近接
わんがぷりっく	ワンガ・プリック	固有名詞	TF2のスパイの近接
こんないばーずくない	コンナイバーズ・クナイ	固有名詞	TF2のスパイの近接
びっぐあーなー	ビッグ・アーナー	固有名詞	TF2のスパイの近接
すぱいしくる	スパイ・シクル	固有名詞	TF2のスパイの近接

とうめいうぉっち	透明ウォッチ	固有名詞	TF2のスパイの時計
いんすーじあすとずたいむぴーす	インスージアストズ・タイムピース	固有名詞	TF2のスパイの時計
くぁっけんばーど	クァッケンバード	固有名詞	TF2のスパイの時計
くろーくあんどだがー	クロークアンドダガー	固有名詞	TF2のスパイの時計
でっどりんがー	デッドリンガー	固有名詞	TF2のスパイの時計



さくしー	サクシー	固有名詞	TF2の全クラスの近接
こんしぇんしゃすおぶじぇくたー	コンシェンシャス・オブジェクター	固有名詞	TF2の全クラスの近接
ふらいぱん	フライパン	固有名詞	TF2の全クラスの近接
ふりーだむすたっふ	フリーダム・スタッフ	固有名詞	TF2の全クラスの近接
ばっとあうたへる	バット・アウタ・ヘル	固有名詞	TF2の全クラスの近接
めもりーめーかー	メモリー・メーカー	固有名詞	TF2の全クラスの近接
はむしゃんく	Ham Shank	固有名詞	TF2の全クラスの近接
ごーるでんふらいぱん	ゴールデンフライパン	固有名詞	TF2の全クラスの近接

