さんだんじゅう	Scattergun	固有名詞	TF2のスカウトのメイン武器
ふぉーすあねーちゃー	Force-A-Nature	固有名詞	TF2のスカウトのメイン武器
しょーとすとっぷ	Shortstop	固有名詞	TF2のスカウトのメイン武器
そーだぽっぱー	Soda Popper	固有名詞	TF2のスカウトのメイン武器
べびーふぇいすずぶらすたー	Baby Face's Blaster	固有名詞	TF2のスカウトのメイン武器
ばっくすきゃったー	Back Scatter	固有名詞	TF2のスカウトのメイン武器

るがーもーふ	Lugermorph	固有名詞	TF2のスカウトのサブ武器
うぃんがー	Winger	固有名詞	TF2のスカウトのサブ武器
ぷりてぃぼーいずぽけっとぴすとる	Pretty Boy's Pocket Pistol	固有名詞	TF2のスカウトのサブ武器
ふらいんぐぎろちん	Flying Guillotine	固有名詞	TF2のスカウトのサブ武器
ぼんくあとみっくぱんち	Bonk! Atomic Punch	固有名詞	TF2のスカウトのサブ武器
くりてぃこーら	Crit-a-Cola	固有名詞	TF2のスカウトのサブ武器
まっどみるく	Mad Milk	固有名詞	TF2のスカウトのサブ武器
みゅーてぃてっどみるく	Mutated Milk	固有名詞	TF2のスカウトのサブ武器

ばっと	Bat	固有名詞	TF2のスカウトの近接
ほーりーまらかる	HolyMackerel	固有名詞	TF2のスカウトの近接
あんあーむどこんばっと	Unarmed Combat	固有名詞	TF2のスカウトの近接
さんどまん	Sandman	固有名詞	TF2のスカウトの近接
きゃんでぃーけーん	Candy Cane	固有名詞	TF2のスカウトの近接
ぼすとんばっしゃー	Boston Basher	固有名詞	TF2のスカウトの近接
すりーるーんぶれいど	Three-Rune Blade	固有名詞	TF2のスカウトの近接
さんおんあすてぃっく	Sun-on-a-Stick	固有名詞	TF2のスカウトの近接
ふぁんおぶうぉー	Fan O'War	固有名詞	TF2のスカウトの近接
あとまいざー	Atomizer	固有名詞	TF2のスカウトの近接
らっぷあさしん	Wrap Assasin	固有名詞	TF2のスカウトの近接
